XXXXXXXXXXXX
XX..XXXXXMXX
X...XXXXX.XX
X...XXXXX.XX
XJJJXXXXX.XX
XGGG.....JXX
XXXXXXXXXGXX
XXXXXXXXXXXX