XXXXXXXXXXXX
XX..XXXXXXXX
X...XXXXXXXX
X...XXXXXXXX
XJJJXXXXXMXX
XGGG.....JXX
XXXXXXXXXGXX
XXXXXXXXXXXX