XXXXXXXXXXXX
X...X......X
XGJ........X
XGJ....M.XXX
X...J...XXXX
XGJ.G...XXXX
XXXXXXXXXXXX