XXXXXXXXXXXX
X.G.GX.....X
X.....G....X
X.J.J.J..XXX
XGJ....MXXXX
X...X...XXXX
XXXXXXXXXXXX