XXXXXXXX
XXX..XXX
XX....XX
XGJM.JGX
XXXXXXXX
