XXXXXXXXXX
X.....G..X
X..GG....X
X..JXJ...X
X.GJ.J.M.X
X........X
XXXXXXXXXX