XXXXXXXXXX
X.....G..X
X..GG....X
X..JJJ...X
X.GJ...M.X
X........X
XXXXXXXXXX