XXXXXXXX
XXXGGXXX
XX.JJ.XX
XGJM.JGX
XXXXXXXX
