XXXXXXXX
XXXX...X
XXXX...X
XXXX.JXX
XXXXX.MX
XXXXX..X
X..GXJ.X
X....J.X
XG.GXXXX
XXXXXXXX
