XXXXXXXXX
XXXXX...X
XX...J..X
XX..XGG.X
X..JXXXXX
XGJMXXXXX
XXXXXXXXX
XXXXXXXXX
