XXXXXXXX
XX..GG.X
XX..X..X
XXXGXXXX
X.JJXXXX
X.XGJMXX
X...XXXX
XXXXXXXX
