XXXXXXXXXXXX
X..X.......X
X.X...JX...X
X...XX.....X
X.G.....GM.X
X.....J....X
X.....X....X
XXXXXXXXXXXX
