XXXXXXXXX
X.......X
X.......X
X.......X
XXJ..JM.X
X...GXG.X
X.X.....X
XXXXXXXXX
