XXXXXXXXXXX
X....J...GX
X....J..M.X
X.........X
XG........X
X.........X
X.........X
X.X.......X
XXXXXXXXXXX
