XXXXXXXXXXXXXXXX
X....G.........X
XX....X........X
X.....J........X
XX..XM.......X.X
XXXXXXXXXXXXXXXX
