XXXXXX
X....X
X...XX
X..X.X
X...GX
X....X
X.X.MX
X....X
X....X
X....X
XX...X
X...JX
X....X
XXXXXX
