XXXXXXXXXX
X.J......X
X.......XX
X..X..G..X
X........X
X.X...X..X
X...J.X..X
X.....M..X
X...X..G.X
XXXXXXXXXX
